10 20 3
####################
#a**%***** $*      #
#$  ****** ######$ #
#*******   D$*$ ***#
##### %  #######   #
#***$****?    %    #
#****&***     $****#
####DD######      $#
# ** $$    *    ?  #
####################