11 20 2
####################
#a %  ************ #
# ***$*     ?   *$*#
# *      $$$      *#
# $** #########    #
#  ##  $******* ## #
#      *******     #
# $   ######### *$ #
# &** *  $$$  *  ? #
# ****D**** ***&***#
####################